{
  "calendar": {
    "startYear": 1570,
    "endYear": 1800,
    "currentYear": 1570,
    "numberOfPlayedTurns": 0
  },
  "units": [
    {
      "id": 0,
      "type": "COLONIST",
      "ownerId": "Dutch",
      "placeCargoSlot": {},
      "cargo": {
        "slots": []
      },
      "availableMoves": 0
    },
    {
      "id": 1,
      "type": "COLONIST",
      "ownerId": "Dutch",
      "placeCargoSlot": {},
      "cargo": {
        "slots": []
      },
      "availableMoves": 0
    },
    {
      "id": 2,
      "type": "COLONIST",
      "ownerId": "Dutch",
      "placeCargoSlot": {},
      "cargo": {
        "slots": []
      },
      "availableMoves": 0
    },
    {
      "id": 3,
      "type": "GALLEON",
      "ownerId": "Dutch",
      "placeMap": {
        "location": {
          "x": 35,
          "y": 15
        }
      },
      "cargo": {
        "slots": [
          {"unitId": 0},
          {"unitId": 1},
          {"unitId": 2},
          {},
          {}
        ]
      },
      "availableMoves": 0
    }
  ],
  "colonies": [],
  "map": {
  	"seed": 134,
    "tiles": [
      "column  :1,2,3,4,5,6,7,8,9,0,1,2,3,4,5,6,7,8,9,0,1,2,3,4,5,6,7,8,9,0,1,2,3,4,5,6,7,8,9,0",
      "row-0001:a,a,a,a,a,a,a,a,a,a,a,a,a,a,a,a,a,a,a,a,a,a,a,a,a,a,a,a,a,a,a,a,a,a,a,a,a,a,a,a",
      "row-0002:~,_,_,_,_,_,_,_,_,_,t,t,t,a,a,a,a,_,_,_,t,_,_,_,_,t,_,_,_,_,t,_,_,_,t,_,_,_,t,t",
      "row-0003:~,_,_,_,_,_,_,_,_,_,_,_,_,_,_,_,_,_,_,_,_,_,_,_,_,_,_,_,_,_,_,_,_,_,_,_,_,_,_,~",
      "row-0004:~,_,_,_,_,_,_,_,_,_,_,_,_,_,_,_,_,_,_,_,_,_,_,_,_,_,_,_,_,_,_,_,_,_,_,_,_,_,_,~",
      "row-0005:~,_,_,_,_,_,_,_,_,_,_,_,_,_,_,_,_,_,_,_,_,_,_,_,_,_,_,_,_,_,_,_,_,_,_,_,_,_,_,~",
      "row-0006:~,_,_,_,_,_,_,_,_,_,_,_,_,_,_,_,_,_,_,_,_,_,_,_,_,_,_,_,_,_,_,_,_,_,_,_,_,_,_,~",
      "row-0007:~,_,_,_,_,_,_,_,_,_,_,_,_,_,_,_,_,_,_,_,_,_,_,_,_,_,_,_,_,_,_,_,_,_,_,_,_,_,_,~",
      "row-0008:~,_,_,_,_,_,_,_,_,_,_,_,_,_,_,_,_,_,_,_,_,_,_,_,_,_,_,_,_,_,_,_,_,_,_,_,_,_,_,~",
      "row-0009:~,_,_,_,_,_,_,_,_,_,_,_,_,_,_,_,_,_,_,_,_,_,_,_,_,_,_,_,_,_,_,_,_,_,_,_,_,_,_,~",
      "row-0010:~,_,_,_,_,_,_,_,_,_,_,_,_,_,_,_,_,_,_,_,_,_,_,_,_,_,_,_,_,_,_,_,_,_,_,_,_,_,_,~",
      "row-0011:~,_,_,_,_,_,_,_,_,_,_,_,_,_,_,_,_,_,_,_,_,_,_,_,_,_,_,_,_,_,_,_,_,_,_,_,_,_,_,~",
      "row-0012:~,_,_,_,_,_,_,_,_,_,_,_,_,_,_,_,_,_,_,_,_,_,_,_,_,_,_,_,_,_,_,_,_,_,_,_,_,_,_,~",
      "row-0013:~,_,_,_,_,_,_,_,_,_,_,_,_,_,_,_,_,_,_,_,_,_,_,_,_,_,_,_,_,_,_,_,_,_,_,_,_,_,_,~",
      "row-0014:~,_,_,_,_,_,_,_,_,_,_,_,_,_,_,_,_,_,_,_,_,_,_,_,_,_,_,_,_,_,_,_,_,_,_,_,_,_,_,~",
      "row-0015:~,_,_,_,_,_,_,_,_,_,_,_,_,_,_,_,_,_,_,_,_,_,_,_,_,_,_,_,_,_,_,_,_,_,_,_,_,_,_,~",
      "row-0016:~,_,_,_,_,_,_,_,_,_,_,_,_,_,_,_,_,_,_,_,_,_,_,_,_,_,_,_,_,_,_,_,_,_,_,_,_,_,_,~",
      "row-0017:~,_,_,_,_,_,_,_,_,_,_,_,_,_,_,_,_,_,_,_,_,_,_,_,_,_,_,_,_,_,_,_,_,_,_,_,_,_,_,~",
      "row-0018:~,_,_,_,_,_,_,_,_,_,_,_,_,_,_,_,_,_,_,_,_,_,_,_,_,_,_,_,_,_,_,_,_,_,_,_,_,_,_,~",
      "row-0019:~,_,_,_,_,_,_,_,_,_,_,_,_,_,_,_,_,_,_,_,_,_,_,_,_,_,_,_,_,_,_,_,_,_,_,_,_,_,_,~",
      "row-0020:~,_,_,_,_,_,_,_,_,_,_,_,_,_,_,_,_,_,_,_,_,_,_,_,_,_,_,_,_,_,_,_,_,_,_,_,_,_,_,~",
      "row-0021:~,_,_,_,_,_,_,_,_,_,_,_,_,_,_,_,_,_,_,_,_,_,_,_,_,_,_,_,_,_,_,_,_,_,_,_,_,_,_,~",
      "row-0022:~,_,_,_,_,_,_,_,_,_,_,_,_,_,_,_,_,_,_,_,_,_,_,_,_,_,_,_,_,_,_,_,_,_,_,_,_,_,_,~",
      "row-0023:~,_,_,_,_,_,_,_,_,_,_,_,_,_,_,_,_,_,_,_,_,_,_,_,_,_,_,_,_,_,_,_,_,_,_,_,_,_,_,~",
      "row-0024:~,_,_,_,_,_,_,_,_,_,_,_,_,_,_,_,_,_,_,_,_,_,_,_,_,_,_,_,_,_,_,_,_,_,_,_,_,_,_,~",
      "row-0025:~,_,_,_,_,_,_,_,_,_,_,_,_,_,_,_,_,_,_,_,_,_,_,_,_,_,_,_,_,_,_,_,_,_,_,_,_,_,_,~",
      "row-0026:~,_,_,_,_,_,_,_,_,_,_,_,_,_,_,_,_,_,_,_,_,_,_,_,_,_,_,_,_,_,_,_,_,_,_,_,_,_,_,~",
      "row-0027:~,_,_,_,_,_,_,_,_,_,_,_,_,_,_,_,_,_,_,_,_,_,_,_,_,_,_,_,_,_,_,_,_,_,_,_,_,_,_,~",
      "row-0028:~,_,_,_,_,_,_,_,_,t,_,_,_,_,_,_,_,t,_,_,_,_,_,_,_,t,_,_,_,_,_,_,_,t,_,_,_,_,_,~",
      "row-0029:~,_,_,_,_,_,_,_,t,a,t,_,_,_,_,_,t,a,t,_,_,_,_,_,t,a,t,_,_,_,_,_,t,a,t,_,_,_,_,~",
      "row-0030:a,a,a,a,a,a,a,a,a,a,a,a,a,a,a,a,a,a,a,a,a,a,a,a,a,a,a,a,a,a,a,a,a,a,a,a,a,a,a,a"
    ],
    "trees": [
      "column  :1,2,3,4,5,6,7,8,9,0,1,2,3,4,5,6,7,8,9,0,1,2,3,4,5,6,7,8,9,0,1,2,3,4,5,6,7,8,9,0",
      "row-0001:~,_,_,_,_,_,_,_,_,_,_,_,_,_,_,_,_,_,_,_,_,_,_,_,_,_,_,_,_,_,_,_,_,_,_,_,_,_,_,~",
      "row-0002:~,_,_,_,_,_,_,_,_,_,_,_,_,_,_,_,_,_,_,_,_,_,_,_,_,_,_,_,_,_,_,_,_,_,_,_,_,_,_,~",
      "row-0003:~,_,_,_,_,_,_,_,_,_,_,_,_,_,_,_,_,_,_,_,_,_,_,_,_,_,_,_,_,_,_,_,_,_,_,_,_,_,_,~",
      "row-0004:~,_,_,_,_,_,_,_,_,_,_,_,_,_,_,_,_,_,_,_,_,_,_,_,_,_,_,_,_,_,_,_,_,_,_,_,_,_,_,~",
      "row-0005:~,_,_,_,_,_,_,_,_,_,_,_,_,_,_,_,_,_,_,_,_,_,_,_,_,_,_,_,_,_,_,_,_,_,_,_,_,_,_,~",
      "row-0006:~,_,_,_,_,_,_,_,_,_,_,_,_,_,_,_,_,_,_,_,_,_,_,_,_,_,_,_,_,_,_,_,_,_,_,_,_,_,_,~",
      "row-0007:~,_,_,_,_,_,_,_,_,_,_,_,_,_,_,_,_,_,_,_,_,_,_,_,_,_,_,_,_,_,_,_,_,_,_,_,_,_,_,~",
      "row-0008:~,_,_,_,_,_,_,_,_,_,_,_,_,_,_,_,_,_,_,_,_,_,_,_,_,_,_,_,_,_,_,_,_,_,_,_,_,_,_,~",
      "row-0009:~,_,_,_,_,_,_,_,_,_,_,_,_,_,_,_,_,_,_,_,_,_,_,_,_,_,_,_,_,_,_,_,_,_,_,_,_,_,_,~",
      "row-0010:~,_,_,_,_,_,_,_,_,_,_,_,_,_,_,_,_,_,_,_,_,_,_,_,_,_,_,_,_,_,_,_,_,_,_,_,_,_,_,~",
      "row-0011:~,_,_,_,_,_,_,_,_,_,_,_,_,_,_,_,_,_,_,_,_,_,_,_,_,_,_,_,_,_,_,_,_,_,_,_,_,_,_,~",
      "row-0012:~,_,_,_,_,_,_,_,_,_,_,_,_,_,_,_,_,_,_,_,_,_,_,_,_,_,_,_,_,_,_,_,_,_,_,_,_,_,_,~",
      "row-0013:~,_,_,_,_,_,_,_,_,_,_,_,_,_,_,_,_,_,_,_,_,_,_,_,_,_,_,_,_,_,_,_,_,_,_,_,_,_,_,~",
      "row-0014:~,_,_,_,_,_,_,_,_,_,_,_,_,_,_,_,_,_,_,_,_,_,_,_,_,_,_,_,_,_,_,_,_,_,_,_,_,_,_,~",
      "row-0015:~,_,_,_,_,_,_,_,_,_,_,_,_,_,_,_,_,_,_,_,_,_,_,_,_,_,_,_,_,_,_,_,_,_,_,_,_,_,_,~",
      "row-0016:~,_,_,_,_,_,_,_,_,_,_,_,_,_,_,_,_,_,_,_,_,_,_,_,_,_,_,_,_,_,_,_,_,_,_,_,_,_,_,~",
      "row-0017:~,_,_,_,_,_,_,_,_,_,_,_,_,_,_,_,_,_,_,_,_,_,_,_,_,_,_,_,_,_,_,_,_,_,_,_,_,_,_,~",
      "row-0018:~,_,_,_,_,_,_,_,_,_,_,_,_,_,_,_,_,_,_,_,_,_,_,_,_,_,_,_,_,_,_,_,_,_,_,_,_,_,_,~",
      "row-0019:~,_,_,_,_,_,_,_,_,_,_,_,_,_,_,_,_,_,_,_,_,_,_,_,_,_,_,_,_,_,_,_,_,_,_,_,_,_,_,~",
      "row-0020:~,_,_,_,_,_,_,_,_,_,_,_,_,_,_,_,_,_,_,_,_,_,_,_,_,_,_,_,_,_,_,_,_,_,_,_,_,_,_,~",
      "row-0021:~,_,_,_,_,_,_,_,_,_,_,_,_,_,_,_,_,_,_,_,_,_,_,_,_,_,_,_,_,_,_,_,_,_,_,_,_,_,_,~",
      "row-0022:~,_,_,_,_,_,_,_,_,_,_,_,_,_,_,_,_,_,_,_,_,_,_,_,_,_,_,_,_,_,_,_,_,_,_,_,_,_,_,~",
      "row-0023:~,_,_,_,_,_,_,_,_,_,_,_,_,_,_,_,_,_,_,_,_,_,_,_,_,_,_,_,_,_,_,_,_,_,_,_,_,_,_,~",
      "row-0024:~,_,_,_,_,_,_,_,_,_,_,_,_,_,_,_,_,_,_,_,_,_,_,_,_,_,_,_,_,_,_,_,_,_,_,_,_,_,_,~",
      "row-0025:~,_,_,_,_,_,_,_,_,_,_,_,_,_,_,_,_,_,_,_,_,_,_,_,_,_,_,_,_,_,_,_,_,_,_,_,_,_,_,~",
      "row-0026:~,_,_,_,_,_,_,_,_,_,_,_,_,_,_,_,_,_,_,_,_,_,_,_,_,_,_,_,_,_,_,_,_,_,_,_,_,_,_,~",
      "row-0027:~,_,_,_,_,_,_,_,_,_,_,_,_,_,_,_,_,_,_,_,_,_,_,_,_,_,_,_,_,_,_,_,_,_,_,_,_,_,_,~",
      "row-0028:~,_,_,_,_,_,_,_,_,_,_,_,_,_,_,_,_,_,_,_,_,_,_,_,_,_,_,_,_,_,_,_,_,_,_,_,_,_,_,~",
      "row-0029:~,_,_,_,_,_,_,_,_,_,_,_,_,_,_,_,_,_,_,_,_,_,_,_,_,_,_,_,_,_,_,_,_,_,_,_,_,_,_,~",
      "row-0030:~,_,_,_,_,_,_,_,_,_,_,_,_,_,_,_,_,_,_,_,_,_,_,_,_,_,_,_,_,_,_,_,_,_,_,_,_,_,_,~"
    ],
    "maxX": 40,
    "maxY": 30
  },
  "players": [
    {
      "name": "Dutch",
      "computer": false,
      "gold": 2108,
      "declaredIndependence": false,
	    "visible": {
	    	"visible": [
	          "column  :1,2,3,4,5,6,7,8,9,0,1,2,3,4,5,6,7",
	          "row-0001:#,#,#,#,#,#,#,#,#,#,#,#,#,#,#,#,#",
	          "row-0002:#,#,#,#,#,#,#,#,#,#,#,#,#,#,#,#,#",
	          "row-0003:#,#,#,#,#,#,#,#,#,#,#,#,#,#,#,#,#",
	          "row-0004:#,#,#,#,#,#,#,#,#,#,#,#,#,#,#,#,#",
	          "row-0005:#,#,#,#,#,#,#,#,#,#,#,#,#,#,#,#,#",
	          "row-0006:#,#,#,#,#,#,#,#,#,#,#,#,#,#,#,#,#",
	          "row-0007:#,#,#,#,#,#,#,#,#,#,#,#,#,#,#,#,#",
	          "row-0008:#,#,#,#,#,#,#,#,#,#,#,#,#,#,#,#,#",
	          "row-0009:#,#,#,#,#,#,#,#,#,#,#,#,#,#,#,#,#",
	          "row-0010:#,#,#,#,#,#,#,#,#,#,#,#,#,#,#,#,#",
	          "row-0011:#,#,#,#,#,#,#,#,#,#,#,#,#,#,#,#,#",
	          "row-0012:#,#,#,#,#,#,#,#,#,#,#,#,#,#,#,#,#",
	          "row-0013:#,#,#,#,#,#,#,#,#,#,#,#,#,#,#,#,#",
	          "row-0014:#,#,#,#,#,#,#,#,#,#,#,#,#,#,#,#,#"
	       ]
	    }
    },
    {
      "name": "Dutch's King",
      "computer": true,
      "gold": 1108,
      "declaredIndependence": false,
      "whosKingThisPlayerIs": "Dutch",
       "visible": {
	    	"visible": []
    	}
    }
  ],
  "europe": {},
  "campaign": {
  	"name": "default",
  	"mission": "findNewWorld"
  },
  "focusedField": {
    "x": 35,
    "y": 15
  }
}