               |
      o        |
     ooo oo    |
   o o ooo     |
   o o oo      |
   o ooo       |
   ooooo       |
     o         |
               |
               |
----------------