
{
    "maxX": 17,
    "maxY": 12,
    "map-layer": [
		"a,a,a,a,a,a,a,a,a,a,a,a,a,a,a,a,a",
		"~,_,_,_,_,_,_,_,_,_,t,t,t,a,a,a,a",
		"~,_,_,_,_,g,g,g,_,_,_,_,_,_,_,_,~",
		"~,_,_,_,g,g,g,g,g,_,_,_,_,_,_,_,~",
		"~,_,_,_,_,_,g,g,g,g,_,_,_,_,_,_,~",
		"~,_,_,_,_,_,_,_,g,g,_,_,_,_,_,_,~",
		"~,_,_,_,_,_,_,_,_,_,_,_,_,_,_,_,~",
		"~,_,_,_,g,g,g,_,_,_,_,_,_,_,_,_,~",
		"~,_,_,g,g,g,g,g,_,_,_,g,_,_,_,_,~",
		"~,_,_,_,_,g,g,_,_,_,_,g,g,g,_,_,~",
		"~,_,_,_,_,_,_,_,_,_,_,_,_,_,_,_,~",
		"a,a,a,a,a,a,a,a,a,a,a,a,a,a,a,a,a"
    ]
}	